12x12
0 0 0 0 0 0 96 0 0 0 37 0
0 0 51 0 0 0 0 0 0 0 0 0
0 0 0 0 0 0 0 16 16 16 0 0
0 0 16 16 0 0 64 0 0 16 0 0
0 0 0 0 0 0 0 16 0 0 16 0
32 0 32 0 0 0 0 0 0 96 0 0 
0 0 16 16 0 0 17 0 0 0 0 0
96 0 17 17 17 17 0 0 0 0 0 0
0 0 17 0 0 0 0 0 0 0 0 0
0 0 0 0 0 0 16 16 16 0 0 96
0 17 0 96 0 18 0 0 0 0 0 0
0 0 0 96 0 0 0 0 0 0 0 0
