12x12
0 0 0 0 0 0 96 0 0 0 37 0
0 0 49 0 0 0 0 0 0 0 0 0
0 0 0 0 0 0 0 16 16 16 0 0
0 0 16 16 0 0 64 0 0 16 0 0
0 0 0 0 0 0 0 0 0 0 16 0
32 0 32 0 0 0 0 33 0 96 0 0 
0 0 16 16 0 0 0 0 0 0 34 0
0 0 17 17 17 17 0 0 36 0 0 0
0 0 0 0 0 0 0 0 0 0 0 0
0 0 0 0 0 0 0 0 16 0 0 0
0 17 0 0 0 52 0 0 0 0 0 0
0 0 0 0 0 0 0 0 0 0 0 0
