12x12
0 0 0 0 0 0 0 37 0 0 0 0
0 0 17 0 16 0 64 0 0 34 0 0 
0 0 17 0 0 0 0 0 0 0 0 0
0 0 17 0 0 0 17 0 0 0 0 0
0 0 0 32 0 0 0 0 33 0 0 0
0 0 0 0 0 0 0 16 0 16 16 0 
0 0 16 16 0 0 0 0 0 0 96 0
0 0 0 0 0 17 17 0 96 0 0 0
16 16 16 17 17 0 0 0 0 0 0 0
0 0 0 0 0 16 16 0 16 0 0 0
0 35 0 0 0 50 0 0 0 0 96 0
0 0 0 0 0 0 0 0 0 0 0 0
